2233344444
2333344445
2333344445
3333444555
3444455555
3444455555
3444455555
3444455555
3444455555
3444444555