43444444555455555444333333333344555554444455665554455566566638388333656656666333336666663336666565545555554563636666666666366333366663366655665554444445445445666666665655
33334444445454554444334433344444555544444555666555455566663338338363656666666333336666663366665566556665555663636666666666666666333663366655665554445455444455636666666655
33344444445555554443333333344444444444445555666665555566663338888333666363336636666663666665666666556655555666666666666666666663333333366655555444455555455556566666666665
44444444555555554433333333343334444544455555566666666666666338388366656366366666633633666366636666666555666633666656666333336666333333666555555554455555455556666666666666
44444445555555544433333333333344444555555555556999999666566338888366556633336666666666666666333333666665666336666666633333666663333336655545555554455556555566555563333366
44444455445544444444443444444444444545555555555566666655556638833366555666333666636636666666333833336666666336666666336666666663333366655555555554445555555666666663333333
44455555555545444444444444444444444544454554455556666655556663333665555566336666633333633333333833336666566336665666333336666663333366655555555554555555555666656666363333
44455566555544444555555554444444444554444444445455666655555666666655555556666666336333633338333333333666666636665663333366665666666666555555655554455556555666555566633333
55455566555444455566665555444444444444444444455444555555444555555554544556636666666663333333333333333666656636666663333366555666666655566666666655555555655565556666666666
44555565555445555555566665544444333443343444444444555555444444544445555555666333666633333336636633663666656666666666666666666666655555556666666665556655655666666666666666
45555555565555555555566665444333333333333444455544445555444444434444545555565666666663333336666666663666656666656565666666665666655555556666666665566665555555555666666663
44454555565555555545566665443333333433443444555444444444444444444444444555555566566666666666666666663666666666666566666666666665655555556666666665555655555555556666666666
44444455565565555444556655443333333333443444455444444444443334444434445555555555556556555665666666363336666666656565556666666666655555556666666666555655555554555666666666
33444445566665555554555555444444444444444444444444344444444444334444445554444455555555555666666636363666666666655555566333665655555555556566665555555555555544545566666663
44444555566666655555555555443334434444444455554443333434444443344444444444444445555554445566666666363636666656655556666333655555666555556666665555555555555554555566666663
34445555556666666666655555454444444444544444554443333434444444444455555555444555554444344556666333333366655666666666666666655555555555556666666655556565655655554455666663
34445555555565656665555555544444444444444434444443444444444444455555555555444444444344444555666666666666555555666666666666665555666655556566656655566666666655554555566666
33445554545555556666655555444444554554444444444443444444545555555555555555444544544444445556666336666666655556666666666666666656666655555555556665666636666666665665566666
44444444434444545555655555444444444444443444454444444444444556666666666655554554443344445556666666666666665566666666666665666666666655565565566666666633336666666666666666
44444444433444445555554555544444443444444444444443444444444556666666666654444555554444445555666666666666655566666666666666666666666666666565566666666633333666666666666666
44444333333443444555544444444344444444444444444444444444444556333366665554444455554454455666666666555666666666666666666666666636333666666565566666666633336666666333666666
44433333433343334455544444444334344555544445555444444454444556336666666554444555555544445666333366656656666333336666666666666666333366666665566666666666663666663363666666
44444444444443334444444444444333344445544544444444433444445556666366665555544555555555555666666666655555666633333666666666666666333366666666666666655566666666666666666666
44444444444443333444444333433333344445555544444444444455555556663366665555544445555555555666666633665555666633333366656666666566666665566666566666666666666666666666666666
43444443444443333444444333333333344444444444544555555555566556666366666666555554455666666666666633366666636663333666556666666566666655555555556655565666566666566566666666
33344443344343333444444333333333334444445555544445555666666655566336666665554554456666656665655633336666666663333366656666555556666665555555556655555666565566566666666663
44444444444344444444444433323333333344445555544455555555566656566666666655555554556666666655555633333666666566633366656556555555666665555555566655565666565565566666666666
44433443443344444555444433223333333344445555544445555555566655556333336655555555555666666655555633883366666666663666656656555455663666555556666666665655565555566666666666
55444444443333445555444433333334444444445554544455555556666656666633333665555655555666666666656633383366555556666666655555555555663336665555666665565655565566566666666366
55444455554333444444444444333444444455445455444455555556666666666663333665555555555555555566555563333366555555566666555555555556633336665566633336636666666555556666666666
55445455554333344444343334334445554455445455544455555555566663666663333665556665555555555555555566633666555555555666554444555556663666666655666636636666666666565666633336
54455455444333333443344444445556665455444455554555555556666656666666633665556665555555555555555555566666555555555556555554555566633333366655633366666666663666666666633333
54455455444333333443333344455566665555545555555555555666666666666655666655556665554555455556554455566555555444455555555544444456633663366666633336633333633333366666666333
55555444444444444433344344556666555565555555555555555555555555655555666555555655555555555555544444555555555555455555555444444456633666666666636636333333363333366666636363
55555444344344444444444444566665555555555565655555555555555555555555665544455555555555555555544444555455555555445555544444444455633663366666666666633336666633336666666666
44444444444344444344445455566666555555555566655555555555555555555544555444445555555555555555554544444444555554445555545445444456633363363366636666633333666663336663666666
45544443333334443344455555566666655555666666655555545555655556555555555444444444555455455555554444444444545444445454444444444445666666366336636636333636666663636666666566
44444433333344443334455666663666666665666336665555545555665555555555555444444445555444445444544444444444555554444444444445454556666666366666666666333336666666666333666566
34444433332333333333455566663666665655666336665555545555665555565555454444444444444444445444544444434444445444434445455555455566666663336666666666633636666666633336665566
33444433332333333334455566666666666665666336555555444455555555555554444454444444444444445444544444434444445444434444555656555663666663366666555666333666666333333336666666
33444432222333433333444555665555556666666666555455444455555444444554554454444444344445445444444444445444444444444445555656666663666666666655555666666666666333333336655566
33333433333343443333344555555555555666655655444444444555444444444444444455454444444444445444444444444444444444444445566666666333666656666655555666666666666333633636655556
33333333333343444333333445555444455555555554443333434444444444444444444444554444444455555554444344444444444544444455666666663333666666666666655666336666666633333336655666
33333333333343444333333445554444445555555444444333334434444444434444444445554444455555555444444344444434444544444455566663633336655555666366656663333666666633333336666666
33333333443333333333333444444433344455544444444334444434445544433434433444554444445555555555454454444444444544555555666666666336665555566663666663333666666663333336666666
33333344443333334333333344445444434444444444443333333333444444433434433444554444545555555555555555444344445544555555666666666636656565566666665666333666656666666666655555
32333344443333334334333334444444333344334344444333333333444443334444443444454444445566666666665555544444544544555566666666666566556566666666655666666655655566666666665555
33333344443333343344333333334443333344333344444343333333444433333444433444454445545565665556565555554454544444555565666666666566556556666666655656655555555556666666665544
33333333333333343344344333334444443333333334444443333333444333333444444444454445555565666555555555555455545544545565665555666566556556666666655555655545555555555656655444
33333333333333344344343333334444443333334434444443333333344333334444444444445455556666666665555555555454555554444455555555555555555555666666666656654444455555555555544443
43443343333333344444444333334444444334444444444443333333344333334444444444445445556636666566556555554454555554444555554444555555555545566666656655554544555555555555544444
44443333333333344454444333344444444344445444444433333333434333334344444444444445556636666555555555544444555554444555554555555566555555566666655555555545556655555544444444
43333343333233344454444334444555544444555444444433333333334333333344444444444444456636366555555565555444555554544555655554555566565555566666666555555555555655555444333434
43333343333233445554444344444444444455555444444433333333444444333344445444444344556666666555555565554444555555555555655554555565566556666666666555555555565655555443333444
33333343343333444555444444444444444445455444444433333334444444443344555554444344555556665555555555554444455555555566655444555565666666666666665555566666666666554433233334
33333333333333444444443334344344444455555444444433334445555555444345555554444445555555555544445555544444555555555555655445555666666663336666666665566666666665554443333333
33322333333333444444333334444444444455555444444444444445555555444444545544444444555555555555545555544445555544444555544344455566666666333336636666666666655555555443333333
33222233333333334444444344444444444455555444444444444455555555545445544444444454555555555545445555444445554444444555443334455556665666333336666666663336665555555444333333
32333233333333334444443334444444444444555444445555555555565555545455544444544444555555544444455555444555554434444554544344445556666666333333333666663333665555554443333222
32333233233334344444333334455554444444555444445666665555555555545555544444544444445555444445555555545555555444444554444444545666666666336336633666666366665555444444333322
33333333333333344444333344555555544444444444445666665555444444444555444444444444445544444444445545555566665544455555544444444455555566666666666566566666555555444433333233
43333344433333333444443344445454444444444444445566665555454444444455554445444433444444334444545555555566565555555666655445545556655666666665555555556666566555444433333233
44334334434443333344433334445554444444444444445555555555444444334455444444444444444443333344544545555666565556556656655555555555555666665555565555556666566665544333333333
44333344444444434444444334444554454444434444455555555555444444444455444444444444444444333444444445565666666666566666655555555555555555555556565555555666566665544333334333
44444444444444433444444333444444444444444444444555455555544444444455544444444444544443333444444445566666666556566666666555555556655555555566665555566666666665544333334333
33344444444444434444544333444444444444454444455555556655554444444555554444444444444444444444444555666636666556566666666555556666665555455566666555566666666655544444444444
33334444434444444544443333444444443444444444455556556655554444445555555544445555544444544444444556663333666656555655666665556656665555555666666665566666666665555455555444
33344444444444444444433343444444344444444444455566556655554444455555555555555555444455555554455556666666666655556666666665555666666655555666666666566666666665555555555544
33344444434443444444333333444344444433343444455566555655543444455556666665555655444555555555455556666666666656555655655665555556666666555555666666565566666666655555655555
33334434433333344444433333444444444444444444456666555655553444455566665555555665444556655555555666666666333366555655655666555556666665555555666665555555666665556666666555
