4344444455
3333444445
3334444444
4444444455
4444444555
4444445544
4445555555
4445556655
5545556655
4455556555